 ,B, ,B, ,B, ,B,
B, ,B, ,B, ,B, ,
 ,B, ,B, ,B, ,B,
 , , , , , , , ,
 , , , , , , , ,
R, ,R, ,R, ,R, ,
 ,R, ,R, ,R, ,R,
R, ,R, ,R, ,R, ,